bbbbbbbbbb bbbbbbbbbbb
b e    bbb bbb  eb   b
b bb b bbb bbb b   b b
b bb b bbb bbb bbb b b
b                  b b
b bb bbbbb bbb b bbb b
b bb   b       b   b b
b bb b b bbb b b b b b
b    b   bbb b   b   b
bbbbebbbtdgb bbbpbbbeb
b    b   bbb b   b   b
b bb b b bbb b b b b b
b bb   b       b   b b
b bb bbbbb bbb b bbb b
b                  b b
b bb b bbb bbb bbb b b
b bb b bbb bbb b   b b
b e    bbb bbb  eb   b
bbbbbbbbbb bbbbbbbbbbb